128
24
00000000000000000000000000000000000000000000000000000000000000000000000000000000000000000000000000000000000000000000000000000000
00000000000000000000000000000000000000000000000000000000000000000000000000000000000000000000000000000000000000000000000000000000
00000000000000000000000000000000000000000000000000000000000000000000000000000000000000000000000000000000000000000000000000000000
00000000000000000000000000000000000000000000000000000000000000000000000000000000000000000000000000000000000000000000000000000000
00000000000000000000000000000000000000000000000000000000000000000000000000000000000000000000000000000000000000000000000000000000
00000000000000000000000000000000000000000000000000000000000000000000000000000000000000000000000000000000000000000000000000000000
00000000000000000000000000000000000000000000000000000000000000000000000000000000000000000000000000000000000000000000000000000000
00000000000000000000000000000000000000000000000000000000000000000000000000000000000000000000000000000000000000000000000000000000
00000000000000000000000000000000000000000000000000000000000000000000000000000000000000000000000000000000000000000000000000000000
00000000000000000000000000000000000000000000000000000000000000000000000000000000000000000000000000000000t00000000000000000000000
00000000000000000000000000000000000000000000000000000000000000000000000000000000000000000000000000000000000t00000000000000000000
00000000000000000000000000000000000000000000000000000000000000000000000000000000000000000000000000000000000000000000000000000000
000000000000000000000t0000000000000000000000000000000000000000000000fff000fff000fff00000ff000000ff000001111114500000000000000000
0000000000000000000000000t000000t0000000000000000000000t000000001000000000000000000000000000000000000001111111145000000000000000
000000000000000000t000000000000000000t000000t00000000000000110001000000000000000000000000000000000000001111111111450000000000t00
0000000000000t000000023000045000000t00000000000000000000000110001000000000000000000000000000000000000001111111111114500000000000
000t00000000000t00023000000004500000000000011100000000111001100010000000000000000000000000000000000000011111111111111450000t0000
00000t00000000000230000000000011111111100001110000000011100110001000000000000000000000000000000000000001111111111111111450000d00
0t000000000011111111111111111111111111100001110000000011100110001000000000000000000000000000000000000001111111111111111111111111
000@0000000011111111111111111111111111100001110000000011100110001000000000000000000000000000000000000001111111111111111111111111
11111111100011111111111111111111111111100001110000000011100110001000000000000000000000000000000000000001111111111111111111111111
11111111100011111111111111111111111111100001110000000011100110001000000000000000000000000000000000000001111111111111111111111111
11111111100011111111111111111111111111100001110000000011100110001000000000000000000000000000000000000001111111111111111111111111
11111111100011111111111111111111111111100001110000000011100110001000000000000000000000000000000000000001111111111111111111111111
*------------------------------------------------------------------------------------------------------------------------------*
00000000000000000000000000000000000000000000000000000000000000000000000000000000000000000000000000000000000000000000000000000000
00000000000000000000000000000000000000000000000000000000000000000000000000000000000000000000000000000000000000000000000000000000
00000000000000000000000000000000000000000000000000000000000000000000000000000000000000000000000000000000000000000000000000000000
00000000000000000000000000000000000000000000000000000000000000000000000000000000000000000000000000000000000000000000000000000000
00000000000000000000000000000000000000000000000000000000000000000000000000000000000000000000000000000000000000000000000000000000
00000000000000000000000000000000000000000000000000000000000000000000000000000000000000000000000000000000000000000000000000000000
00000000000000000000000000000000000000000000000000000000000000000000000000000000000000000000000000000000000000000000000000000000
00000000000000000000000000000000000000000000000000000000000000000000000000000000000000000000000000000000000000000000000000000000
00000000000000000000000000000000000000000000000000000000000000000000000000000000000000000000000000000000000000000000000000000000
00000000000000000000000000111000000000000000000000000000000000000000000000000000000000000000000000000000000000000000000000000000
00000000000000000000000000111000000000000000000000000000000000000000000000000000000000000000000000000000000000000000000000000000
00000000000000000000000000111000000000000011100000000000000000000000000000000000000000000000000000000000000000000000000000000000
00000000000000000000000000111000000000000011100000000000000000000000000000000000000000000000000000000000000000000000000000000000
00000000000000000000000000111100000000000011100000000000000000000000000000000000000000000000000000000000000000000000000000000000
00000000000000000000000000111100000000000011100000000000000000000000000000000000000000000000000000000000000000000000000000000000
00000001110000000000000000111100000000000011100000000000000000000000000000000000000000000000000000000000000000000000000000000000
00000001110000000000000000101100000000000111100000000000000000000000000000000000000000000000000000000000000000000000000000000000
00000001110000000000000000000100000000000110100000000000000000000000000000000000000000000000000000000000000000000000000000000000
00000011110000000000000000000000000000000110000000000000000000000000000000000000000000000000000000000000000000000000000000000000
00000011110000000000000000000000000000000110000000000000000000000000000000000000000000000000000000000000000000000000000000000000
00000011110000000000000000000000000000000110000000000000000000000000000000000000000000000000000000000000000000000000000000000000
00000010110000000000000000000000000000000110000000000000000000000000000000000000000000000000000000000000000000000000000000000000
00000000110000000000000000000000000000000110000000000000000000000000000000000000000000000000000000000000000000000000000000000000
00000000010000000000000000000000000000000110000000000000000000000000000000000000000000000000000000000000000000000000000000000000
